XModem	KEYWORD1
ProtocolType	KEYWORD3
bulk_data	KEYWORD3
begin	KEYWORD2
setIdSize	KEYWORD2
setChecksumSize	KEYWORD2
setDataSize	KEYWORD2
setSendInitByte	KEYWORD2
setRetryLimit	KEYWORD2
setSignalRetryDelay	KEYWORD2
allowNonSequentailBlocks	KEYWORD2
bufferPacketReads	KEYWORD2
setRecieveBlockHandler	KEYWORD2
setBlockLookupHandler	KEYWORD2
setChksumHandler	KEYWORD2
send	KEYWORD2
send_bulk_data	KEYWORD2
lookup_send	KEYWORD2
receive	KEYWORD2
XMODEM	LITERAL1
CRC_XMODEM	LITERAL1
